bool[,] map = new bool[,]
{
  {	1,	1,	1,	1,	1,	1,	1,	1,	1,	1,	1,	0	},
  {	1,	1,	1,	1,	1,	1,	1,	1,	1,	1,	1,	0	},
  {	1,	1,	1,	1,	1,	0,	0,	0,	0,	0,	0,	0	},
  {	1,	1,	1,	1,	1,	0,	1,	1,	1,	1,	1,	0	},
  {	0,	0,	0,	0,	0,	0,	1,	1,	1,	1,	1,	0	},
  {	1,	1,	1,	1,	1,	1,	1,	1,	1,	1,	1,	0	}
};

int[,] waypoints = new int[,]
{
  {5,4},
  {5,2},
  {2,11}
}

bool[,] map = new bool[,]
{
  {	1,	1,	1,	1,	1,	1,	1,	1,	1,	1,	1,	1,	1,	1,	1,	1,	1,	0	},
  {	1,	1,	1,	1,	1,	1,	1,	1,	1,	1,	1,	1,	1,	1,	1,	1,	1,	0	},
  {	1,	1,	1,	1,	0,	0,	0,	0,	0,	0,	0,	1,	1,	1,	1,	1,	1,	0	},
  {	1,	1,	1,	1,	0,	1,	1,	1,	1,	1,	0,	1,	1,	1,	1,	1,	1,	0	},
  {	1,	1,	1,	1,	0,	1,	1,	1,	1,	1,	0,	1,	1,	1,	1,	1,	1,	0	},
  {	1,	1,	1,	1,	0,	1,	1,	1,	1,	1,	0,	1,	1,	1,	0,	0,	0,	0	},
  {	0,	0,	0,	0,	0,	0,	0,	0,	0,	0,	0,	1,	1,	1,	0,	1,	1,	0	},
  {	1,	1,	1,	1,	0,	1,	1,	1,	1,	1,	1,	1,	1,	1,	0,	1,	1,	0	},
  {	1,	1,	1,	1,	0,	0,	0,	0,	0,	0,	0,	0,	0,	0,	0,	1,	1,	0	},
  {	1,	1,	1,	1,	1,	1,	1,	1,	1,	1,	1,	1,	1,	1,	1,	1,	1,	0	},
  {	1,	1,	1,	1,	1,	1,	1,	1,	1,	1,	1,	1,	1,	1,	1,	1,	1,	0	}
};

int[,] waypoints = new int[,]
{
  {10,6},
  {10,2},
  {4,2},
  {4,8},
  {14,8},
  {14,5},
  {17,5}
}

bool[,] map = new bool[,]
{
  {	1,	1,	1,	1,	1,	1,	1,	1,	1,	1,	1,	1,	1,	1,	1,	1,	1,	0	},
  {	1,	1,	1,	0,	0,	0,	0,	0,	0,	0,	0,	0,	0,	0,	0,	1,	1,	0	},
  {	1,	1,	1,	0,	1,	1,	1,	1,	1,	1,	1,	1,	1,	1,	0,	1,	1,	0	},
  {	1,	1,	1,	0,	1,	1,	1,	1,	1,	1,	1,	1,	1,	1,	0,	1,	1,	0	},
  {	1,	1,	1,	0,	1,	1,	1,	1,	1,	1,	0,	0,	0,	0,	0,	1,	1,	0	},
  {	1,	1,	1,	0,	1,	1,	1,	1,	1,	1,	0,	1,	1,	1,	1,	1,	1,	0	},
  {	1,	1,	1,	0,	1,	1,	1,	1,	1,	1,	0,	1,	1,	1,	1,	1,	1,	0	},
  {	1,	1,	1,	0,	1,	1,	1,	1,	1,	1,	0,	0,	0,	0,	0,	0,	0,	0	},
  {	1,	1,	1,	0,	1,	1,	1,	1,	1,	1,	1,	1,	1,	1,	1,	1,	1,	0	},
  {	0,	0,	0,	0,	1,	1,	1,	1,	1,	1,	1,	1,	1,	1,	1,	1,	1,	0	},
  {	1,	1,	1,	1,	1,	1,	1,	1,	1,	1,	1,	1,	1,	1,	1,	1,	1,	0	}
};

int[,] waypoints = new int[,]
{
  {3,9},
  {3,1},
  {14,1},
  {14,4},
  {10,4},
  {10,7},
  {17,7}
}